57 H,H,H,H
61 H,H,H,K
69 H,H,K,H
71 H,H,K,K
43 H,K,H,H
55 H,K,H,K
62 H,K,K,H
72 H,K,K,K
72 K,H,H,H
61 K,H,H,K
75 K,H,K,H
58 K,H,K,K
59 K,K,H,H
66 K,K,H,K
66 K,K,K,H
53 K,K,K,K