7 H,H,H,H
2 H,H,H,K
7 H,H,K,H
11 H,H,K,K
5 H,K,H,H
3 H,K,H,K
8 H,K,K,H
5 H,K,K,K
9 K,H,H,H
7 K,H,H,K
6 K,H,K,H
7 K,H,K,K
6 K,K,H,H
7 K,K,H,K
5 K,K,K,H
5 K,K,K,K